NO textures/TECH_1A.xpm
SO textures/TECH_2A.xpm
WE textures/TECH_3D.xpm
EA textures/TECH_4C.xpm

F 61,69,69
C 28,28,28

11111111111111111
10000000000010001
10000000000010001
1000000000001CCC1
10000001000000001
100A000W000000001
10000000000000001
1C100000000000001
10100000000000001
11111111111111111
