NO textures/BRICK_3C.xpm
SO textures/BRICK_3D.xpm
WE textures/BRICK_4B.xpm
EA textures/BRICK_4D.xpm

F 100,100,0
C 20,30,0

11111111111111111
10000001000010001
10000001000010001
1000000100001CCC1
10000001000000001
1000000W000000001
10000000000000001
1C100000000000001
10100000000000001
11111111111111111
